{
  "map" : [
    [
      [3, 3, 3, 1, 1, 1, 1, 1, 1, 1, 1, 1, 1],
      [3, 3, 3, 1, 1, 1, 1, 1, 1, 1, 1, 1, 1],
      [3, 3, 3, 3, 3, 3, 3, 3, 1, 1, 1, 1, 1],
      [3, 3, 3, 7, 7, 7, 7, 3, 1, 1, 1, 1, 1],
      [3, 3, 3, 1, 1, 1, 1, 3, 1, 1, 1, 1, 1],
      [3, 3, 3, 7, 7, 7, 7, 3, 1, 1, 1, 1, 1],
      [3, 3, 3, 3, 3, 3, 3, 3, 1, 1, 1, 1, 1],
      [3, 3, 3, 3, 3, 1, 1, 1, 1, 1, 1, 1, 1],
      [3, 3, 3, 1, 1, 1, 1, 1, 1, 1, 1, 1, 1],
      [3, 3, 3, 1, 1, 1, 1, 1, 1, 1, 1, 1, 1]
    ]
  ],
  "shift" : [0, 0],
  "borders" : {
    "pos_x" : 0,
    "pos_y" : 0,
    "width" : 800,
    "height" : 600
  }
}


