{
  "map" : [
    [
      [2, 1, 1, 1, 1, 1, 1, 1, 1, 1],
      [1, 2, 1, 1, 1, 1, 1, 1, 1, 1],
      [1, 1, 2, 1, 1, 1, 1, 1, 1, 1],
      [1, 1, 1, 2, 1, 1, 1, 1, 1, 1],
      [1, 1, 1, 1, 2, 1, 1, 1, 1, 1],
      [1, 1, 1, 1, 1, 2, 1, 1, 1, 1],
      [1, 1, 1, 1, 1, 1, 2, 1, 1, 1],
      [1, 1, 1, 1, 1, 1, 1, 2, 1, 1],
      [1, 1, 1, 1, 1, 1, 1, 1, 2, 1],
      [1, 1, 1, 1, 1, 1, 1, 1, 1, 2]
    ]
  ],
  "shift" : [0, 0],
  "borders" : {
    "pos_x" : 0,
    "pos_y" : 0,
    "width" : 800,
    "height" : 600
  }
}


